NO assets/north_wall.xpm
SO assets/east_wall.xpm
WE assets/south_wall.xpm
EA assets/west_wall.xpm

F 20,20,20
C 200,200,200

1111111111
1000000001
1000000001
1000W00001
1000001101
1000000001
1111111111
