NO assets/n_wall.xpm
SO assets/s_wall.xpm
WE assets/w_wall.xpm
EA assets/e_wall.xpm

F 20,20,20
C 200,200,200

111111111111111111111111111111111111111111111111111111111111
100000000000000000000000000000000000000000000000000000000001
100000000000000011100000000000000000000000000000000000000001
100001100001100000000000111000000000000000000000000000000001
1E0000000000000000000000111000000000000000000000000000000001
100000100000110011000000000000000000000000000000000000000001
100000000010000000010000000000000000000000000000000000000001
100000000000000000000000000000000000000000000000000000000001
111111111111111111111111111111111111111111111111111111111111
