NO ./assets/north_wall.xpm
WE ./assets/west_wall.xpm
EA ./assets/east_wall.xpm
SO ./assets/south_wall.xpm

C 153,204,255
F 255,50,184

11111111111111111111
10010000000000000001
100D0000000000000001
10010000000000000001
11110000000111111111
10000000000100000001
10000E00000D00000001
10000000000100000001
10000000000100000001
10000000000111111111
11D11111111100000001
10000000000100000001
10000000000D00000001
10000000000100000001
11111111111111111111
